////////////////
/##############/
/#      #@    #/
/#       .    #/
/#      ##    #/
/#            #/
/####         #/
/#     $##    #/
/#            #/
/#    ####    #/
/#    ##      #/
/#            #/
/#    $#. #   #/
/#     #      #/
/##############/
////////////////