////////////////////
/##################/
/#@               #/
/#          #.    #/
/#   #.#    #### ##/
/#    .           #/
/#  #####         #/
/#      #         #/
/###### ##### #####/
/##  ##  ##       #/
/#  $ #  ##   #   #/
/#  $    ##.  #$  #/
/### ### ## #  $  #/
/#            #   #/
/##################/
////////////////////